level=equal#unequal  
madam=lady#sir  
racecar=fast#slow  
radar=detect#miss  
refer=mention#ignore  
deified=holy#unholy  
repaper=rewrite#keep  
civic=urban#rural  
noon=midday#midnight  
kind=generous#mean  
incorrect=wrong#right  
smart=intelligent#dumb  
early=premature#late  
hardworking=diligent#lazy  
fast=speedy#slowly  
modern=contemporary#old-fashioned  
expensive=costly#cheap  
overreact=exaggerate#stay calm  
angry=furious#calm  
disapprove=reject#approve  
beautiful=gorgeous#ugly  
strong=sturdy#frail  
brave=courageous#fearful  
loyal=faithful#disloyal  
unsafe=risky#secure  
friendly=amiable#unfriendly  
dry=arid#wet  
underpay=undercompensate#overpay  
disagree=argue#agree  
light=luminous#dark  
healthy=fit#sick  
heavy=weighty#light  
honest=truthful#dishonest  
tough=hard#soft  
underestimate=belittle#overestimate  
rewrite=edit#keep  
calm=peaceful#anxious  
disloyal=unfaithful#loyal  
misplace=lose#find  
thin=slim#fat  
tall=towering#short  
love=affection#hate  
soft=smooth#rough  
unsafe=dangerous#safe  
hard=tough#soft  
sharp=pointed#dull  
unknown=mysterious#familiar  
overestimate=exaggerate#underestimate  
safe=secure#dangerous  
incorrect=wrong#right  
antibac=germ-killing#bacterial  
antibiotic=medicinal#harmful  
polite=courteous#rude  
postgraduate=advanced#undergraduate  
pretest=practice#final test  
dislike=hatred#like  
cold=chilly#hot  
insecure=anxious#confident  
postwar=after-war#prewar  
overconfident=arrogant#humble  
incomplete=unfinished#complete  
mislead=deceive#guide  
misbehave=act out#behave  
postgrad=advanced#undergraduate  
warm=cozy#cold  
precook=partially cook#fully cook  
redo=rework#abandon  
funny=humorous#serious  
invisible=hidden#visible  
gentle=tender#harsh  
clean=spotless#dirty  
quiet=silent#noisy  
palindrome=same#same
